40 40
1111111111111111111111111111111111111111
1000111000000000000100000000000100000001
1000000000000000000100000000000100000001
1000000000000000000000000100001000000001
1000200011100000000000000100010000000001
1000000000000100000000110100001000000001
1000000000000100100100000100010000000001
1000000111100100100100001100000100000001
1000000001100000100100011100000100110001
1011000000000011100100010000000000000001
1000000011000111100100000000001000000001
1000000001000000000100000100000000111111
1010000001111100000000000010000000011111
1010001011000000000000000001000000000001
1010000011110000000111100001000000000001
1010001111000000000000000001000000000001
1000000000000000000100111000100000000001
1000000111100110000100001000000000000001
1000000000000000000100001000010000000001
1111111000000000000000000100000000000011
1000000000000011111100000100000000000001
1000111000000000000100000110000100000001
1000000000000000000100000000000100000001
1000000000000000000001000100001000000001
1000000011100000000001000101010000000001
1000000000000100000000110100001000000001
1000000000000100100100000100011000000001
1000000111100100100100001001111100000001
1000000001100000100000001001000100110001
1011000000000000000000010001000000000001
1000000011000111100100000000001000000001
1000000001000000000100000100000000111111
1010000001100100000000000010000000011111
1010001011000001000000000001000000000001
1010000000010001000111100001000000000001
1010001111000001000000000001000000030001
1000000000000000000100111000100000000001
1000000111100110000100001000000000000001
1000000000000000000100001000010000000001
1111111111111111111111111111111111111111