9 16
1111111111111111
1000111000000031
1000000000000001
1000000000000001
1000200011100001
1000000000000101
1000000000000101
1000000111100101
1111111111111111
