40 40 
1111111111111111111111111111111111111111
1000000000000000000000000000000000000001
1000000000000000000000000000000000000001
1000000000000011111111111111111000000001
1000000200000000000000000000000000010001
1000000000000000000000000000000000010001
1000000000000000000010000000000000010001
1000000000000000000000000000000000010001
1000000001111111000010000000000000010001
1000000000000000000010001000000000010001
1000000000000000000010001010000000010001
1000000000000000000010001000000000010001
1000000000000000000010001000000000010001
1000000000001111100000001000100000000001
1000000000000000000000000000000000010001
1000000000000000000000000000000000010001
1000000000000000000000000100000000010001
1000000000000000000001000000000000000001
1000000000000000000001000001000000000001
1000000000000000000001000000000000000001
1000000000000000000001000000000000001001
1000000000000000000000000000000000000001
1000000000000000001100111100010000000001
1000000000000000000000000010000000000001
1000000000000000000000000010000000000001
1000000000000000000000000010000000000001
1000000000000000000000000010000000000001
1000000000000000000000000010000000000001
1000000000000000000000000000000000000001
1000000000000000000000000000000000000001
1000000000000000000000000000000000000001
1000000000000000000000000000000000000001
1000000000000000000000000000000000000001
1000000000000000000000000000000000000001
1000000000000000000000000000000000000001
1000000000000000000000000000000000000001
1000000000000000000000000000000000000001
1000000000000000000000000000000000000001
1000000000000000000000000000000000000031
1111111111111111111111111111111111111111
