9 28
1111111111111111111111111111
1000111000000000000100000001
1000000000000000000100000001
1000000000000000000000000101
1000200011100000000000000101
1000000000000100000000110101
1000000000000100100103000101
1000000111100100100100001101
1111111111111111111111111111
